################
#123#      O   #
#   #      #   #
#   #  * * #   #
#   #   '  #   #
#   #  '%' #   #
# * o      #  @#
################